stat_smoo|stat_smooth|r
segmentation|segmentation_final_name|r
geom_li|geom_line|r
cur_group|cur_group_rows|r
producer_sum|producer_sum_gmv_usd|r
ac|activate|file
|python|file
a|activate|around
vi|virtualenv|around
|activate.R|file
|renv|file
jl|julia|around
init|init|around
lock|lock|buffer
act|activate|around
_g|_get_exts|around
sys|system|around
i|ipynb|around
astrobox_qu|astrobox_query|r
read_xls|read_xlsx|r
end|endfunction|around
Slime|SlimeOverrideConfig|around
10|100|around
split|split|around
zs|zshrc|around
JuliaWe|JuliaWeave|around
Julia|JuliaActivate|around
|logo.png|file
juliaci|juliacircles|around
post|post|around
acces|access_token|around
getf|getfield|buffer
response|response|around
begin|begin|buffer
readsv|readsvg|around
down|download|around
julia|juliacircles|around
read|readsvg|around
Down|Downloads|buffer
begin|begin|around
Maybe|MaybeDateTime|buffer
data|data|around
maybeda|maybedatetime|around
end|end|around
e|end|around
JSON|JSONTables|buffer
datefr|dateformat|around
Data|DataFrame|buffer
String|String|around
url|url|around
ASTROBOX|ASTROBOX_USER|buffer
Dataf|DataFrame|around
readlie|readlines|around
IO|IOBuffer|around
Dataframe|DataFrames|buffer
eachline|eachline|around
IOB|IOBuffer|around
parameters|parameters|around
auten|authenticate|around
|Query.jl|file
|Astrobox|file
Omn|Omnitool.jl|file
authe|authenticate|buffer
auth|authenticate|around
Omni|Omnitool|around
Omni|Omnitool|buffer
Dataframes|DataFrames|buffer
Data|DataFrames|around
reada|readavailable|around
http|https|around
exec|executor|around
secre|secret_id|around
user|user_authorization|r
Au|Authorization|around
clie|client_credentials|around
ASTROBOX_pass|ASTROBOX_PASS|around
Aut|Authorization|around
Expo|Exponential|around
alp|alpha|around
alph|alpha|around
alpha|alpha|around
syntax|syntax|around
astrobox_quer|astrobox_query|r
closeall|closeAllConnections|r
param|parameters|r
astrobox_|astrobox_authenticate|r
quiet|quietly|r
ste|stream_in|r
quie|quietly|r
Multin|Multinomial|around
Plots|Plots|buffer
high|highlighting|around
resp_bo|resp_body_json|r
req_body_js|req_body_json|r
req_perfor|req_perform|r
req_dry|req_dry_run|r
req_|req_dry_run|r
req_bod|req_body_json|r
req_per|req_perform|r
req_|req_url_query|r
req_url_|req_url_path_append|r
eachc|eachcol|around
rand|rand|around
i|isamples|around
Multi|Multinomial|around
Distri|Distributions|around
gmv_|gmv_usd|around
is_reurs|is_recursive|around
sto|stopwords|r
tim|timestamp|around
asd|arcticicestudio|around
query|query|around
subgraph|subgraph|around
is|is_recursive|around
product_id|product_id|around
file.si|file.size|r
par|parse|around
recu|recursive_gmv_usd|around
diferen|diferenca_percentual|around
topific|topification|around
p_recursive_gmv|p_recursive_gmv_usd|around
scri|scripts|file
interna|internal|r
biased_|biased_lemmas|r
lang|language|r
expect_ty|expect_type|r
text|text|r
product_id|product_id|buffer
pr_ru|pr_run|r
str_coun|str_count|r
enc|enc2utf8|r
rawtoChar|rawToChar|r
len|length|around
as.integer|as.integer64|r
as.inte|as.integer64|r
integer|integer64|r
inte|integer64|r
is_intera|is_interactive|r
Sys.get|Sys.getenv|r
secret_base|secret_base_arn|r
user_au|user_authorization|r
user_aut|user_authorization|r
as.matr|as.matrix|r
as_logi|as_logical|r
NU|NULL|r
min_su|min_support|around
set_depen|set_dependency|r
set_new|set_new_model|r
spli|splice|r
set_model_en|set_model_engine|r
apri|apriori|r
|2022.csv|file
astrobox|astrobox_query|r
astrobox_authenticate|astrobox_authenticate|r
is_ver|is_verbose|r
is_|is_verbose|r
z|zshrc|around
false|FALSE|r
show|showWarnings|r
verbose|verbose|r
cli_progress_upda|cli_progress_update|r
write_|write_character|r
local_con|local_connection|r
local_tempfi|local_tempfile|r
local_co|local_connection|r
with_tem|with_tempfile|r
Str|Streaming|around
req_meth|req_method|r
with_en|with_environment|r
astrobo|astrobox_authenticate|r
expect_|expect_type|buffer
authent|authenticate|r
from|fromJSON|r
fl|flatten|r
upgr|upgrade|r
with_con|with_connection|r
getO|getOption|r
FALS|FALSE|r
astrob|astrobox|buffer
astrobo|astrobox_query|around
medi|median|r
recursi|recursive_gmv_usd_rank_by_producer_office|around
buyer|buyer|around
p_recu|p_recursive_gmv_usd|around
transac|transactions|around
grou|group_by|r
suppressWa|suppressWarnings|r
null|null|around
hub|hub_index_m10_user_affiliate_id|around
affiliate_bu|affiliate_buyers_affiliate|around
hub_inde|hub_index_m10_user_buyer_id|around
writeCh|writeChar|r
progress_forma|progress_format|r
cli_progress_ste|cli_progress_step|r
n_chun|n_chunks|r
progress_form|progress_format|r
progres|progress_make|r
environ|environment|r
cli_progress_|cli_progress_step|r
astrobox_authe|astrobox_authenticate|r
parti|partial|r
cli_progress_up|cli_progress_update|r
tot|total|r
cli_progress_ba|cli_progress_bar|r
message|message_update|r
messa|message_update|r
str_cou|str_count|r
resi|resize|around
expect_ty|expect_type|buffer
enc2ut|enc2utf8|r
expect|expect_success|r
suppressw|suppressWarnings|r
bash_pr|bash_profile|around
veb|verbose|around
file.cre|file.create|r
part|partial|r
prog|prog_id|r
enviro|environment|r
query_req|query_req_body_json|around
query_re|query_req_headers|r
st|stream_in|r
resp|resp_check_status|r
write|write_character|r
rawToChar|rawToChar|r
writeB|writeBin|r
tm|tempfile|around
tempfi|tempfile|r
httr|httr2|r
req_sr|req_stream|r
astrobox|astrobox_authenticate|r
expect_su|expect_success|r
use_test|use_test|r
req_body|req_body_form|r
user_a|user_authorization|around
user_|user_authorization|r
use_da|use_data|r
usethis|usethis|r
req_hea|req_headers|r
req_ur|req_url_query|r
astrobox_qu|astrobox_query|around
as|astrobox_authenticate|around
mtcars|mtcars|r
sele|select|r
seoul|seoul256|around
|seoul256.vim|file
|colors|file
seoul256|seoul256.vim|file
seo|seoul256|around
seoul|seoul256|buffer
|include|file
|MacOS|file
|Contents|file
Py|Python.app|file
|Info.plist|file
|Resources|file
|Python.framework|file
|Frameworks|file
lo|local|file
|bin|file
|share|file
|pkgconfig|file
|lib|file
|3.9.10|file
py|python@3.9|file
Ce|Cellar|file
|Homebrew|file
|local|file
li|lib|file
py|pygments|around
py|python3|around
local|local|around
seou|seoul256|around
|plugged|file
|nvim|file
tree|treesitter|around
vim|vim|around
client|client_id|r
|2022|file
input|input|file